1, 1, 30, 0, 0, 3, 3, 3, 3
1, 2, 32, 0, 0, 4, 3, 3, 3
1, 3, 34, 0, 0, 4, 4, 3, 3
1, 4, 36, 0, 0, 4, 4, 4, 3
1, 5, 38, 0, 0, 4, 4, 4, 4