1, 1, 20, 0, 0, 3, 3, 3, 3
1, 2, 20, 0, 0, 4, 3, 3, 3
1, 3, 20, 0, 0, 4, 4, 3, 3
1, 4, 20, 0, 0, 4, 4, 4, 3
1, 5, 20, 0, 0, 4, 4, 4, 4